111111111111111111111111
100C00110000000000001111
1000000110000000C0E00011
100000000000000000000011
1000000000000P0000000001
100000000000000000110001
1000000C0000000001100001
111111111111111111111111
111111111111111111111111
