11111111111111
10C0C0C0C0C0C1
1C0C0CPC0C0C01
10C0C0C0C0C0C1
1C0C0C0C0C0CE1
11111111111111
