1111111111111111111111111111
1E1C0001110000000010000000C1
1P11110000011111101011111111
100001010111000010000000C001
1111011101000000111110111111
100100000000000000000000C001
1001111110111111110111111111
1C000000101000C0010100000001
100000000000000001000000C001
1111111111111111111111111111
